
















#                                 #
#                                 #
#                                 #
#                                 #
#                                 #
#  @                        *     #
###################################