







^                                 ^
#                                 #
#                                 #
#                                 #
#                           ###   #
#########j              ###########
#########               #
        #               #
        #>#             #
        #               #
        #               #
        ##<             #
        #           @   #
        #        ########
        #        #
        #^^^^^^^^#
        ##########