














^                                 ^
#                                 #
#                                 #
#                                 #
#              #      ^^        * #
#         #    #      ##     <#####
#         #    .                  #
#  @      #          ^^^          #
###################################