









^                               ^
#                              <#
#                              <#
#                              <#
#                              <#
#  @             ^ ^        *  <#
######           ###     ########
#                               #
#^^^^^^^^^^^^^^^^^^^^^^^^^^^^^^^#
#################################