







^                                 ^
#                                 #
#                                 #
#                            *    #
#                           ###   #
#########               ###########
#########               #
        #               #
        #<#             #
        #               #
        #               #
        ##>             #
        #           @   #
        #        ########
        #        #
        #^^^^^^^^#
        ##########