
#
#
#
#
#
#
#
#
#
#
#
#                                 ^
#                                 #
# @              ^                #
#                #                #
#                #        *       #
#                ##################
#                #
#     jjj        #
##################