


#
#
#
#
#
#                                                ^
# @                                              #
#                    <###>                       #
#                                                #
#                                                #
###>                                             #
#                                                #         
#            <j>                                 #
#                                                #
#                     ^^^^^^^^^^^^^^^^^          #
#######################################          #
#                                                #
#                                                #
#                                                #
##################################################