






                                ###
                                   #
### #  # ####   ### #   # ###      #
 #  #  # #      #   ##  # #  #     #
 #  #### ###    ### # # # #  #   ##
 #  #  # #      #   #  ## #  #
 #  #  # ###    ### #   # ###    #

 ########
 #      #
 #  @   #
 #      #
 #^^^^^^#
 #******#
 ########